Script started on 2024-04-09 00:10:55-04:00
bash-4.4$ nano `[K~/.bash_profile
[?1049h[22;0;0t[1;24r(B[m[4l[?7h[39;49m[?1h=[?1h=[?1h=[?25l[39;49m(B[m[H[2J[22;35H(B[0;7m[ New File ](B[m[H(B[0;7m         /mnt/scratch/SP24_CS131_Jyotika/ayesp24/.bash_profile                  [1;79H(B[m[23d(B[0;7m^G(B[m Get Help  (B[0;7m^O(B[m Write Out (B[0;7m^W(B[m Where Is  (B[0;7m^K(B[m Cut Text  (B[0;7m^J(B[m Justify   (B[0;7m^C(B[m Cur Pos[24d(B[0;7m^X(B[m Exit[14G(B[0;7m^R(B[m Read File (B[0;7m^\(B[m Replace   (B[0;7m^U(B[m Uncut Text(B[0;7m^T(B[m To Spell  (B[0;7m^_(B[m Go To Line[22d[3d[39;49m(B[m[?12l[?25h[?25l[1;71H(B[0;7mModified(B[m[3da[?12l[?25h[?25ll[?12l[?25h[?25li[?12l[?25h[?25la[?12l[?25h[?25ls[?12l[?25h[?25l [?12l[?25h[?25ll[?12l[?25h[?25l=[?12l[?25h[?25l'[?12l[?25h[?25ll[?12l[?25h[?25ls[?12l[?25h[?25l [?12l[?25h[?25l-[?12l[?25h[?25l'[?12l[?25h[?25l [?12l[?25h[?25ll[?12l[?25h[?25lt[?12l[?25h[?25lr[?12l[?25h[?25l'[?12l[?25h[?25l[4d[?12l[?25h[?25la[?12l[?25h[?25ll[?12l[?25h[?25li[?12l[?25h[?25la[?12l[?25h[?25ls[?12l[?25h[?25l[22d[K[4;7H[?12l[?25h[?25lw[?12l[?25h[?25l	[?12l[?25h[?25l[?12l[?25h[?25l=[?12l[?25h[?25l'[?12l[?25h[?25ll[?12l[?25h[?25ls[?12l[?25h[?25l [?12l[?25h[?25l-[?12l[?25h[?25ll[?12l[?25h[?25l [?12l[?25h[?25l|[?12l[?25h[?25l [?12l[?25h[?25lw[?12l[?25h[?25lc[?12l[?25h[?25l [?12l[?25h[?25l-[?12l[?25h[?25l;[?12l[?25h[?25l [?12l[?25h[?25ll[?12l[?25h[?25l'[?12l[?25h[?25l[22d(B[0;7mSave modified buffer?  (Answering "No" will DISCARD changes.)                   [23;1H Y(B[m Yes[K[24d(B[0;7m N(B[m No  [14G   (B[0;7m^C(B[m Cancel[K[22;63H[?12l[?25h[?25l[23d(B[0;7m^G(B[m Get Help[23;21H(B[0;7mM-D(B[m DOS Format	(B[0;7mM-A(B[m Append[23;61H(B[0;7mM-B(B[m Backup File[24d(B[0;7m^C(B[m Cancel	    (B[0;7mM-M(B[m Mac Format	(B[0;7mM-P(B[m Prepend[24;61H(B[0;7m^T(B[m To Files[22d(B[0;7mFile Name to Write: /mnt/scratch/SP24_CS131_Jyotika/ayesp24/.bash_profile(B[m[74G[?12l[?25h[?25l[K[1;79H[1;71H(B[0;7m        (B[m[22;32H(B[0;7m[ Wrote 2 lines ](B[m[J[24;80H[?12l[?25h[24;1H[?1049l[23;0;0t[?1l>bash-4.4$ source `[K~/.bash_profile
bash-4.4$ l
total 0
-rw-rw-r-- 1 ayesp24 ayesp24 0 Apr  9 00:10 ws4.txt
bash-4.4$ w
2
bash-4.4$ ls
ws4.txt
bash-4.4$ mkdir Subscribers 
bash-4.4$ cd Subscribers
bash-4.4$ wget https://raw.githubusercontent.com/jyotikahp/DemoRepoForCS131/main//Global%20YouTube%20Statistics.csv
--2024-04-09 00:17:58--  https://raw.githubusercontent.com/jyotikahp/DemoRepoForCS131/main/Global%20YouTube%20Statistics.csv
Resolving raw.githubusercontent.com (raw.githubusercontent.com)... 185.199.111.133, 185.199.108.133, 185.199.109.133, ...
Connecting to raw.githubusercontent.com (raw.githubusercontent.com)|185.199.111.133|:443... connected.
HTTP request sent, awaiting response... 200 OK
Length: 200279 (196K) [text/plain]
Saving to: ‘Global YouTube Statistics.csv’

          Global Yo   0%[                    ]       0  --.-KB/s               Global YouTube Stat 100%[===================>] 195.58K  --.-KB/s    in 0.009s  

2024-04-09 00:17:58 (21.6 MB/s) - ‘Global YouTube Statistics.csv’ saved [200279/200279]

bash-4.4$ awk '{ total += $0; count++ } END { print total/count }' subscribers/unnited_states.txt > ws4_means.txt
awk: fatal: cannot open file `subscribers/united_states.txt' for reading (No such file or directory)
bash-4.4$ awk -F, '$8== "United States" { print $3 }' "Global YouTube Statistics..csv" >  subscribers/united_states.txt
bash: subscribers/united_states.txt: No such file or directory
bash-4.4$ ls
'Global YouTube Statistics.csv'   ws4_means.txt
bash-4.4$ mkdir Subscribers[K[K[K[K[K[K[K[K[K[K[K[K[K[K[K[K[Kcd ..
bash-4.4$ ls
Subscribers  ws4.txt
bash-4.4$ rm -r /Subscribers
rm: cannot remove '/Subscribers': No such file or directory
bash-4.4$ rm -r /Subscri[K[K[K[K[K[K[K[K[K[K[K[K[K[Kcd Susc[K[Kbscrfiber[K[K[K[K[Kibers
bash-4.4$ ls
'Global YouTube Statistics.csv'   ws4_means.txt
bash-4.4$ delete '[K[K[K[K[K[K[K[Krm ws4_means.txt
bash-4.4$ rm 'Global YouTube Sta[Katistics.csv'
bash-4.4$ ls
bash-4.4$ cd ..
bash-4.4$ ls
Subscribers  ws4.txt
bash-4.4$ lscd ..[3Plsrm 'Global YouTube Statistics.csv'[C[C[C[C[C[C[C[C[C[C[C[C[C[18Pws4_means.txt[C[C[C[C[C[C[C[C[C[Cls[Kcd Subscribers[C[C[C[C[C[C[C[C[C[Crm -r /Subscribers[C[C[C[C[C[C[C[C[C[Cls[Kcd ..[3Plsawk -F, '$8== "United States" { print $3 }' "Global YouTube Statistics..csv" >  subscribers/united_states.txt[A[C[C[C[C[C[C[C[C[C[C[C[C[C[C'{ total += $0; count++ } END { print total/count }' subscribers/un[6Pited_states.txt > ws4_means.txt[A[C[C[C[C[C[C[C[C[C[Cwget https://raw.githubusercontent.com/jyotikahp/DemoRepoForCS131/main/Global%20YouTube%20Statistics.csv
--2024-04-09 00:39:01--  https://raw.githubusercontent.com/jyotikahp/DemoRepoForCS131/main/Global%20YouTube%20Statistics.csv
Resolving raw.githubusercontent.com (raw.githubusercontent.com)... 185.199.108.133, 185.199.110.133, 185.199.111.133, ...
Connecting to raw.githubusercontent.com (raw.githubusercontent.com)|185.199.108.133|:443... connected.
HTTP request sent, awaiting response... 200 OK
Length: 200279 (196K) [text/plain]
Saving to: ‘Global YouTube Statistics.csv’

          Global Yo   0%[                    ]       0  --.-KB/s               Global YouTube Stat 100%[===================>] 195.58K  --.-KB/s    in 0.009s  

2024-04-09 00:39:01 (21.2 MB/s) - ‘Global YouTube Statistics.csv’ saved [200279/200279]

bash-4.4$ wget https://raw.githubusercontent.com/jyotikahp/DemoRepoForCS131/main//Global%20YouTube%20Statistics.csv[A[C[C[C[C[C[C[C[C[C[Cls[K
[K[A[C[C[C[C[C[C[C[C[C[C[C[Ccd ..[3Plsrm 'Global YouTube Statistics.csv'[C[C[C[C[C[C[C[C[C[C[C[C[C[18Pws4_means.txt[C[C[C[C[C[C[C[C[C[Cls[Kcd Subscribers[C[C[C[C[C[C[C[C[C[Crm -r /Subscribers[C[C[C[C[C[C[C[C[C[Cls[Kcd ..[3Plsawk -F, '$8== "United States" { print $3 }' "Global YouTube Statistics..csv" >  subscribers/united_states.txt[A[C[C[C[C[C[C[C[C[C[C[C[C[C[C'{ total += $0; count++ } END { print total/count }' subscribers/un[6Pited_states.txt > ws4_means.txt[A[C[C[C[C[C[C[C[C[C[Cwget https://raw.githubusercontent.com/jyotikahp/DemoRepoForCS131/main/Global%20YouTube%20Statistics.csv[A[C[C[C[C[C[C[C[C[C[Cawk '{ total += $0; count++ } END { print total/count }' subscribers/un[2Pited_states.txt > ws4_means.txt
awk: fatal: cannot open file `subscribers/united_states.txt' for reading (No such file or directory)
bash-4.4$ awk '{ total += $0; count++ } END { print total/count }' subscribers/unnited_states.txt > ws4_means.txt[A[C[C[C[C[C[C[C[C[C[Cwget https://raw.githubusercontent.com/jyotikahp/DemoRepoForCS131/main/Global%20YouTube%20Statistics.csv[A[C[C[C[C[C[C[C[C[C[Cls[K
[K[A[C[C[C[C[C[C[C[C[C[C[C[Ccd ..[3Plsrm 'Global YouTube Statistics.csv'[C[C[C[C[C[C[C[C[C[C[C[C[C[18Pws4_means.txt[C[C[C[C[C[C[C[C[C[Cls[Kcd Subscribers[C[C[C[C[C[C[C[C[C[Crm -r /Subscribers[C[C[C[C[C[C[C[C[C[C[4Pcd Subscribers[C[C[C[C[C[C[C[C[C[Cls[Krm ws4_means.txt[C[C[C[C[C[C[C[C[C[Cls[Kcd Subscribers[C[C[C[C[C[C[C[C[C[Crm -r /Subscribers[C[C[C[C[C[C[C[C[C[Cls[Kcd ..[3Plsawk -F, '$8== "United States" { print $3 }' "Global YouTube Statistics..csv" >  subscribers/united_states.txt[1Psubscribers/united_states.txt[C[C[C[C[C[C[C[C subscribers/united_states.txt[C[C[C[C[C[C[C[C[C[C[1Pubscribers/united_states.txt[C[C[C[C[C[C[C[C[CSubscribers/united_states.txt[C[C[C[C[C[C[C[C[C[C
bash-4.4$ awk -F, '$8== "India" { print $3 }' "Global YouTube Statistics.csv" > ssubscribers/india.txt[1Pubscribers/india.txtSubscribers/india.txt[C
bash-4.4$ awk '{ total += $1; count++ } END { print total/count }' Worksheet4/Subbscribers/United_States.txt > ws4_means.txt
awk: fatal: cannot open file `Worksheet4/Subscribers/United_States.txt' for reading (No such file or directory)
bash-4.4$ awk '{ total += $1; count++ } END { print total/count }' Worksheet4/Subbscribers/United_States.txt > ws4_means.txt[A[C[C[C[C[C[C[C[C[C[C[C[C[C[C[C[C[C[C[C[C[C[C[C[C[C[C[C[C[C[C[C[C[C[C[C[C[C[C[C[C[C[C[C[C[C[C[C[C[C[C[C[C[C[C[C[C[C[C[C[C[C[C[C[C[C[C[C[C[C[C[C[C[C[C[C[C[C[C[CSubs[1P[A[C[C[C[C[C[C[C[C[C[C[C[C[C[C[C[C[C[C[C[C[C[C[C[C[C[C[C[C[C[C[C[C[C[C[C[C[C[C[C[C[C[C[C[C[C[C[C[C[C[C[C[C[C[C[C[C[C[C[C[C[C[C[C[C[C[C[C[C[C[C[C[C[C[C[C[CSubsc[1P[A[C[C[C[C[C[C[C[C[C[C[C[C[C[C[C[C[C[C[C[C[C[C[C[C[C[C[C[C[C[C[C[C[C[C[C[C[C[C[C[C[C[C[C[C[C[C[C[C[C[C[C[C[C[C[C[C[C[C[C[C[C[C[C[C[C[C[C[C[C[C[C[C[C[C[CSubscr[1P[A[C[C[C[C[C[C[C[C[C[C[C[C[C[C[C[C[C[C[C[C[C[C[C[C[C[C[C[C[C[C[C[C[C[C[C[C[C[C[C[C[C[C[C[C[C[C[C[C[C[C[C[C[C[C[C[C[C[C[C[C[C[C[C[C[C[C[C[C[C[C[C[C[C[CSubscri[1P[A[C[C[C[C[C[C[C[C[C[C[C[C[C[C[C[C[C[C[C[C[C[C[C[C[C[C[C[C[C[C[C[C[C[C[C[C[C[C[C[C[C[C[C[C[C[C[C[C[C[C[C[C[C[C[C[C[C[C[C[C[C[C[C[C[C[C[C[C[C[C[C[C[CSubscrib[1P[A[C[C[C[C[C[C[C[C[C[C[C[C[C[C[C[C[C[C[C[C[C[C[C[C[C[C[C[C[C[C[C[C[C[C[C[C[C[C[C[C[C[C[C[C[C[C[C[C[C[C[C[C[C[C[C[C[C[C[C[C[C[C[C[C[C[C[C[C[C[C[C[CSubscribe[1P[A[C[C[C[C[C[C[C[C[C[C[C[C[C[C[C[C[C[C[C[C[C[C[C[C[C[C[C[C[C[C[C[C[C[C[C[C[C[C[C[C[C[C[C[C[C[C[C[C[C[C[C[C[C[C[C[C[C[C[C[C[C[C[C[C[C[C[C[C[C[C[CSubscriber[1P[A[C[C[C[C[C[C[C[C[C[C[C[C[C[C[C[C[C[C[C[C[C[C[C[C[C[C[C[C[C[C[C[C[C[C[C[C[C[C[C[C[C[C[C[C[C[C[C[C[C[C[C[C[C[C[C[C[C[C[C[C[C[C[C[C[C[C[C[C[C[CSubscribers[1P[A[C[C[C[C[C[C[C[C[C[C[C[C[C[C[C[C[C[C[C[C[C[C[C[C[C[C[C[C[C[C[C[C[C[C[C[C[C[C[C[C[C[C[C[C[C[C[C[C[C[C[C[C[C[C[C[C[C[C[C[C[C[C[C[C[C[C[C[C[CSubscribers/[1P[A[C[C[C[C[C[C[C[C[C[C[C[C[C[C[C[C[C[C[C[C[C[C[C[C[C[C[C[C[C[C[C[C[C[C[C[C[C[C[C[C[C[C[C[C[C[C[C[C[C[C[C[C[C[C[C[C[C[C[C[C[C[C[C[C[C[C[C[CSubscribers/U[1P[A[C[C[C[C[C[C[C[C[C[C[C[C[C[C[C[C[C[C[C[C[C[C[C[C[C[C[C[C[C[C[C[C[C[C[C[C[C[C[C[C[C[C[C[C[C[C[C[C[C[C[C[C[C[C[C[C[C[C[C[C[C[C[C[C[C[C[CSubscribers/Un[1P[A[C[C[C[C[C[C[C[C[C[C[C[C[C[C[C[C[C[C[C[C[C[C[C[C[C[C[C[C[C[C[C[C[C[C[C[C[C[C[C[C[C[C[C[C[C[C[C[C[C[C[C[C[C[C[C[C[C[C[C[C[C[C[C[C[C[CSubscribers/Uni[1P[A[C[C[C[C[C[C[C[C[C[C[C[C[C[C[C[C[C[C[C[C[C[C[C[C[C[C[C[C[C[C[C[C[C[C[C[C[C[C[C[C[C[C[C[C[C[C[C[C[C[C[C[C[C[C[C[C[C[C[C[C[C[C[C[C[C Subscribers/Un[1@i[A[C[C[C[C[C[C[C[C[C[C[C[C[C[C[C[C[C[C[C[C[C[C[C[C[C[C[C[C[C[C[C[C[C[C[C[C[C[C[C[C[C[C[C[C[C[C[C[C[C[C[C[C[C[C[C[C[C[C[C[C[C[C[C[C[C[C[C[C[C[C[C[C[C[C[C[C[C
[A[C[C[C[C[C[C[C[C[C[C[C[C[C[C[C[C[C[C[C[C[C[C[C[C[C[C[C[C[C[C[C[C[C[C[C[C[C[C[C[C[C[C[C[C[C[C[C[C[C[C[C[C[C[C[C[C[C[C[C[C[C[C[C[C[C[C[C[C[C[C[C[C[C[C[C[C[C[C[C
[A[C[C[C[C[C[C[C[C[C[C[C[C[C[C[C[C[C[C[C[C[C[C[C[C[C[C[C[C[C[C[C[C[C[C[C[C[C[C[C[C[C[C[C[C[C[C[C[C[C[C[C[C[C[C[C[C[C[C[C[C[C[C[C[C[C[C[C[C[C[C[C[C[C[C[C[C[C[C[Cni[1P[A[C[C[C[C[C[C[C[C[C[C[C[C[C[C[C[C[C[C[C[C[C[C[C[C[C[C[C[C[C[C[C[C[C[C[C[C[C[C[C[C[C[C[C[C[C[C[C[C[C[C[C[C[C[C[C[C[C[C[C[C[C[C[C[C[C[C[C[C[C[C[C[C[C[C[C[C[C[Cun[1@i[C[C[C[C[C[C[C[1P[1@s
bash-4.4$ awk '{ total += $1; count++ } END { print total/count }' Worksheet4/Subbscribers/India.txt >> ws4_means.txt[1P[1@i[A[C[C[C[C[C[C[C[C[C[C[C[C[C[C[C[C[C[C[C[C[C[C[C[C[C[C[C[C[C[C[C[C[C[C[C[C[C[C[C[C[C[C[C[C[C[C[C[C[C[C[C[C[C[C[C[C[C[C[C[C[C[C[C[C[C[C[C[C[C[C[C[C[C[C[C[C[C[C[C[C[C[CSubs[1P[A[C[C[C[C[C[C[C[C[C[C[C[C[C[C[C[C[C[C[C[C[C[C[C[C[C[C[C[C[C[C[C[C[C[C[C[C[C[C[C[C[C[C[C[C[C[C[C[C[C[C[C[C[C[C[C[C[C[C[C[C[C[C[C[C[C[C[C[C[C[C[C[C[C[C[C[CSubsc[1P[A[C[C[C[C[C[C[C[C[C[C[C[C[C[C[C[C[C[C[C[C[C[C[C[C[C[C[C[C[C[C[C[C[C[C[C[C[C[C[C[C[C[C[C[C[C[C[C[C[C[C[C[C[C[C[C[C[C[C[C[C[C[C[C[C[C[C[C[C[C[C[C[C[C[C[CSubscr[1P[A[C[C[C[C[C[C[C[C[C[C[C[C[C[C[C[C[C[C[C[C[C[C[C[C[C[C[C[C[C[C[C[C[C[C[C[C[C[C[C[C[C[C[C[C[C[C[C[C[C[C[C[C[C[C[C[C[C[C[C[C[C[C[C[C[C[C[C[C[C[C[C[C[C[CSubscri[1P[A[C[C[C[C[C[C[C[C[C[C[C[C[C[C[C[C[C[C[C[C[C[C[C[C[C[C[C[C[C[C[C[C[C[C[C[C[C[C[C[C[C[C[C[C[C[C[C[C[C[C[C[C[C[C[C[C[C[C[C[C[C[C[C[C[C[C[C[C[C[C[C[C[CSubscrib[1P[A[C[C[C[C[C[C[C[C[C[C[C[C[C[C[C[C[C[C[C[C[C[C[C[C[C[C[C[C[C[C[C[C[C[C[C[C[C[C[C[C[C[C[C[C[C[C[C[C[C[C[C[C[C[C[C[C[C[C[C[C[C[C[C[C[C[C[C[C[C[C[C[CSubscribe[1P[A[C[C[C[C[C[C[C[C[C[C[C[C[C[C[C[C[C[C[C[C[C[C[C[C[C[C[C[C[C[C[C[C[C[C[C[C[C[C[C[C[C[C[C[C[C[C[C[C[C[C[C[C[C[C[C[C[C[C[C[C[C[C[C[C[C[C[C[C[C[C[CSubscriber[1P[A[C[C[C[C[C[C[C[C[C[C[C[C[C[C[C[C[C[C[C[C[C[C[C[C[C[C[C[C[C[C[C[C[C[C[C[C[C[C[C[C[C[C[C[C[C[C[C[C[C[C[C[C[C[C[C[C[C[C[C[C[C[C[C[C[C[C[C[C[C[CSubscribers[1P[A[C[C[C[C[C[C[C[C[C[C[C[C[C[C[C[C[C[C[C[C[C[C[C[C[C[C[C[C[C[C[C[C[C[C[C[C[C[C[C[C[C[C[C[C[C[C[C[C[C[C[C[C[C[C[C[C[C[C[C[C[C[C[C[C[C[C[C[C[CSubscribers/[1P[A[C[C[C[C[C[C[C[C[C[C[C[C[C[C[C[C[C[C[C[C[C[C[C[C[C[C[C[C[C[C[C[C[C[C[C[C[C[C[C[C[C[C[C[C[C[C[C[C[C[C[C[C[C[C[C[C[C[C[C[C[C[C[C[C[C[C[C[CSubscribers/i[1P[A[C[C[C[C[C[C[C[C[C[C[C[C[C[C[C[C[C[C[C[C[C[C[C[C[C[C[C[C[C[C[C[C[C[C[C[C[C[C[C[C[C[C[C[C[C[C[C[C[C[C[C[C[C[C[C[C[C[C[C[C[C[C[C[C[C[C[CSubscribers/in[1P[A[C[C[C[C[C[C[C[C[C[C[C[C[C[C[C[C[C[C[C[C[C[C[C[C[C[C[C[C[C[C[C[C[C[C[C[C[C[C[C[C[C[C[C[C[C[C[C[C[C[C[C[C[C[C[C[C[C[C[C[C[C[C[C[C[C[CSubscribers/ind[1P[A[C[C[C[C[C[C[C[C[C[C[C[C[C[C[C[C[C[C[C[C[C[C[C[C[C[C[C[C[C[C[C[C[C[C[C[C[C[C[C[C[C[C[C[C[C[C[C[C[C[C[C[C[C[C[C[C[C[C[C[C[C[C[C[C[C Subscribers/in[1@d[A[C[C[C[C[C[C[C[C[C[C[C[C[C[C[C[C[C[C[C[C[C[C[C[C[C[C[C[C[C[C[C[C[C[C[C[C[C[C[C[C[C[C[C[C[C[C[C[C[C[C[C[C[C[C[C[C[C[C[C[C[C[C[C[C[C

bash-4.4$ sed -i 's/Hello/Hi/g' greetings.txt
sed: can't read greetings.txt: No such file or directory
bash-4.4$ echo "Hello, John Doe!: > greetings.txt[K[K[K[K[K[K[K[K[K[K[K[K[K[K[K[K[K[K[K[K[K[K[K[K[K[K[K[K[K[K[K[K[K[K[K[K[K[K[Ktouch greei[Ktings.txt
bash-4.4$ vi greetings.txt
[?2004h[?1049h[22;0;0t[?1h=[?2004h[1;24r[?12h[?12l[27m[23m[29m[m[H[2J[?25l[24;1H"greetings.txt" 0L, 0C[2;1H[94m~                                                                               [3;1H~                                                                               [4;1H~                                                                               [5;1H~                                                                               [6;1H~                                                                               [7;1H~                                                                               [8;1H~                                                                               [9;1H~                                                                               [10;1H~                                                                               [11;1H~                                                                               [12;1H~                                                                               [13;1H~                                                                               [14;1H~                                                                               [15;1H~                                                                               [16;1H~                                                                               [17;1H~                                                                               [18;1H~                                                                               [19;1H~                                                                               [20;1H~                                                                               [21;1H~                                                                               [22;1H~                                                                               [23;1H~                                                                               [1;1H[?25h[?25l[m[24;1H[1m-- INSERT --[m[24;13H[K[1;1H[?25h[?25lH[?25h[?25le[?25h[?25ll[?25h[?25ll[?25h[?25lo[?25h[?25l,[?25h[?25l [?25h[?25lJ[?25h[?25lo[?25h[?25lh[?25h[?25ln[?25h[?25l [?25h[?25lD[?25h[?25lo[?25h[?25le[?25h[?25l![?25h[?25l[2;1H[K[2;1H[?25h[?25lH[?25h[?25li[?25h[?25l,[?25h[?25l [?25h[?25lJ[?25h[?25la[?25h[?25ln[?25h[?25le[?25h[?25l [?25h[?25lD[?25h[?25lo[?25h[?25le[?25h[?25l![?25h[?25l[3;1H[K[3;1H[?25h[?25lG[?25h[?25lr[?25h[?25le[?25h[?25le[?25h[?25lt[?25h[?25lin[?25h[?25lg[?25h[?25ls[?25h[?25l,[?25h[?25l [?25h[?25lJ[?25h[?25lo[?25h[?25lh[?25h[?25ln[?25h[?25l [?25h[?25lS[?25h[?25lm[?25h[?25li[?25h[?25lt[?25h[?25lh[?25h[?25l![?25h[?25l[4;1H[K[4;1H[?25h[?25lH[?25h[?25le[?25h[?25ll[?25h[?25ll[?25h[?25lo[?25h[?25l,[?25h[?25l [?25h[?25lM[?25h[?25li[?25h[?25lc[?25h[?25lh[?25h[?25la[?25h[?25ll[?25h[?25le[?25h[?25l[4;14H[K[4;14H[?25h[?25l[4;13H[K[4;13H[?25h[?25le[?25h[?25ll[?25h[?25l [?25h[?25lJ[?25h[?25lo[?25h[?25lh[?25h[?25ln[?25h[?25ls[?25h[?25lo[?25h[?25ln[?25h[?25l![?25h[?25l[5;1H[K[5;1H[?25h[?25lH[?25h[?25li[?25h[?25l,[?25h[?25l [?25h[?25lE[?25h[?25lm[?25h[?25li[?25h[?25ll[?25h[?25l[5;8H[K[5;8H[?25h[?25l[5;7H[K[5;7H[?25h[?25l[5;6H[K[5;6H[?25h[?25l[5;5H[K[5;5H[?25h[?25l[?25h[?25l[5;3H[K[5;3H[?25h[?25l,[?25h[?25l [?25h[?25lE[?25h[?25lm[?25h[?25li[?25h[?25ll[?25h[?25ly[?25h[?25l [?25h[?25lD[?25h[?25la[?25h[?25lv[?25h[?25li[?25h[?25ls[?25h[?25l![?25h[?25l[6;1H[K[6;1H[?25h[24;1H[K[6;1H[?25l[?25h[?25l[24;1H:[?2004h[?25hsq[?25l[24;3H[K[24;3H[?25h[?25l[24;2H[K[24;2H[?25hwq[?25l[?2004l"greetings.txt" 6L, 96C written
[?2004l[?1l>[?25h[?1049l[23;0;0tbash-4.4$ vi greetings.txt[C[C[C[C[C[C[C[C[C[C[3@touch[C[C[C[C[C[C[C[C[C[C[C[C[C[C[C[C[C[C[C[C[C[C[C[C[16@sed -i 's/Hello/Hi/g'[C[C[C[C[C[C[C[C[C[C[C[C[C[C
bash-4.4$ sed -i '/Doe/d' greetings.txt
bash-4.4$ sed -i 's/$/(edited)/' greetings.txt
bash-4.4$ sed -i '/^Hi/s/Michael Johnson/Mike Johnson/' greetings.txt
bash-4.4$ cat greetings. [Ktxt
Greetings, John Smith!(edited)
Hi, Mike Johnson!(edited)
Hi, Emily Davis!(edited)
(edited)
bash-4.4$ vi greetings.txt
[?2004h[?1049h[22;0;0t[?1h=[?2004h[1;24r[?12h[?12l[27m[23m[29m[m[H[2J[?25l[24;1H"greetings.txt" 4L, 91C[1;1HGreetings, John Smith!(edited)
Hi, Mike Johnson!(edited)
Hi, Emily Davis!(edited)
(edited)
[94m~                                                                               [6;1H~                                                                               [7;1H~                                                                               [8;1H~                                                                               [9;1H~                                                                               [10;1H~                                                                               [11;1H~                                                                               [12;1H~                                                                               [13;1H~                                                                               [14;1H~                                                                               [15;1H~                                                                               [16;1H~                                                                               [17;1H~                                                                               [18;1H~                                                                               [19;1H~                                                                               [20;1H~                                                                               [21;1H~                                                                               [22;1H~                                                                               [23;1H~                                                                               [1;1H[?25h[?25l[m[24;1H[1m-- INSERT --[m[24;13H[K[1;1H[?25h


(edited)[?25l[4;8H[K[4;8H[?25h[?25l[4;7H[K[4;7H[?25h[?25l[4;6H[K[4;6H[?25h[?25l[4;5H[K[4;5H[?25h[?25l[4;4H[K[4;4H[?25h[?25l[4;3H[K[4;3H[?25h[?25l[4;2H[K[4;2H[?25h[?25l[4;1H[K[4;1H[?25h[?25l[94m~                                                                               [3;25H[?25h[m[24;1H[K[3;24H[?25l[?25h[?25l[24;1H:[?2004h[?25hEQ[?25l[24;3H[K[24;3H[?25h[?25l[24;2H[K[24;2H[?25hwq[?25l[?2004l"greetings.txt" 3L, 82C written
[?2004l[?1l>[?25h[?1049l[23;0;0tbash-4.4$ vi greetings.txt[C[C[C[C[C[C[C[C[C[C[1@cat[C[C[C[C[C[C[C[C[C[C[C[C[C[C[C[C[C[C[C[C[C[C[C[C[42@sed -i '/^Hi/s/Michael Johnson/Mike Johnson/'[C[C[C[C[C[C[C[C[C[C[C[C[C[C[C[C[C[C[C[C[C[C[C[C[C[C[C[C[C[C[C[C[23Ps/$/(edited)[C[C[C[C[C[C[C[C[C[C[C[C[C[C[C[C[C[C[C[C[C[C[C[C[C[C[C[C[C[C[C[C[C[C[7P/Doe/d[C[C[C[C[C[C[C[C[C[C[C[C[C[C[C[C[C[C[C[C[C[C[C[C[C[C[C[C[C[C[C[C[C[6@s/Hello/Hi/g[C[C[C[C[C[C[C[C[C[C[C[C[C[C[C[C[C[C[C[C[C[C[C[C[C[19Pvi[C[C[C[C[C[C[C[C[C[C[C[C[C[C[C[C[C[C[C[C[C[C[C[C[3@touch[C[C[C[C[C[C[C[C[C[C[C[C[C[C[C[C[C[C[C[C[C[C[C[C[16@sed -i 's/Hello/Hi/g'[C[C[C[C[C[C[C[C[C[C[C[C[C[C[C[C[C[C[C[C[C[C[C[Cawk '{ total += $1; count++ } END { print total/count }' Subscribers/inndia.txt >> ws4_means.txt[A[C[C[C[C[C[C[C[C[C[C[C[C[C[C[C[C[C[C[C[C[C[C[C[